18 20
11111111111111111111
11111111111111111111
11111111111111111111
11111000111111111111
11111200111111111111
11111002111111111111
11100202011111111111
11101011011111111111
10001011011111003311
10200200040000003311
11111011101011003311
11111000001111111111
11111111111111111111
11111111111111111111
11111111111111111111
11111111111111111111
10101010101010101001
11111111111111111111