12 20
11111111111111111111
11111111111111111111
11111111111111111111
11111111111111111111
14000000000000000001
10002000200020000001
10000000000000000001
10002000200020000001
10000000000000003331
10002000200020003331
10000000000000003331
11111111111111111111